####################
#S  #    #         #
### # ## # ####### #
#   # #  #       # #
# ### # ######## # #
#     #          # #
# ########## ### # #
#            #   # #
############ # ### #
#            #     #
# ############ ### #
#            #   # #
# ########### # ## #
#   #         #    #
### # ####### # ## #
#   #       # #  # #
# ######### # ## # #
#           #    # #
########### ########
#                 E#
####################